WE textures/hitler.xpm
NO textures/lag.xpm
SO textures/crew.xpm
EA textures/guns.xpm

F 47,45, 56
C 70 , 70, 70


11111111111111111111111111111111111111
100000000000000000000000000000000000001
1000000000010000000000000S00000000000001
10000000000010000000000000000000000000001
111111111111111111111111111111111111111111
