WE textures/wolfenstein/grey_stone.xpm
NO textures/wolfenstein/purple_stone.xpm
SO textures/wolfenstein/red_brick.xpm
EA textures/wolfenstein/wood.xpm
F 1,38,  1
C 218, 255, 235


          11111111111111111
11111111111111111111111111111111
11111111111111111111111111111111111111
10000000000000000000000000000000000000111
100000000000000000000000000000000000000001
1000000000000000000000000000000000000000011
10000001000000000000000000000011000000000001
10000001000000000000000000000000000010000011
10011100000000000E000000000000000001 10000011
1001110000000000000000000000000000001111111
1111111111111111111111111111111111111
