EA ./textures/3.xpm
NO ./textures/2.xpm
SO ./textures/2.xpm
WE ./textures/3.xpm

C 64,47,29
F 51,51,51

1111111111111111111111
1000000000000000000001
1000000000000000000001
1000000000010000000001
10N0000000000000000001
1111111111111111111111
