                    NO                     melhadou.xpm    
                    WE      	           mtellami.xpm    
                           					SO omansour.xpm   
EA                           						profile.xpm    

C  255, 103, 31         
F 4, 106,56

                                        11111
                                       1000001
        1111111111111111111111          10001           11111111111111111111111111
    1111000000000000000000000011111111110000011111111111000000000000000000000001111111
11110000000000000000000000000000000000000000000000000000000000000000000000000000001111
1111000000000000000000000000000000000000000000S000000000000000000000000000000000001111
11110000000000000000000000000000000000000000000000000000000000000000000000000000001111
    111100000000000000000000001111111111000001111111111100000000000000000000001111
        1111111110001111111111          10001           1111111111111111111111
                10001                   10001                   10001
                10001                   10001                   10001
                10001                   10001                   10001
             11110001111                10001                11110001111
            1000000000001               10001               1000000000001
            1000000000001               10001               1000000000001
             11110001111                10001                11110001111
                10001                   10001                   10001
                10001                   10001                   10001
                10001                   10001                   10001
                1000011111111111111111111000111111111111111111111000111111111111111111111111111111111111111111111111111111111111111111111111111111111111111
                10000000000000000000001110000000000000000000000000000000000000000000000000000000000000000000000000000000000000000000000000000000000000000001
                10000000000000000000000000000000000000000000000000000000000000000000000000000000000000000000000000000000000000000000000000000000000000000001
                10000000000000000000000000000000000000000000000000000000000000000000000000000000000000000000000000000000000000000000000000000000000000000001
                10000000000000000000001110000000000000000000000000000000000000000000000000000000000000000000000000000000000000000000000000000000000000000001
                1111111111111111111111111111111111111111111111111111111111111111111111111111111111111111111111111111111111111111111111111111111111111111111
